1111111111111111111111111
1000000000000000000000001
1000000000011111000000C01
10000P0000010E01000000001
1100000000011111000000001
1111111111111111111111111
