111111111111111111111111
11P000000E000000000000C1
111111111111111111111111
