11111111111111111
100000000000E0001
1C000000000000001
1000000P000000001
10000C00000000001
11111111111111111
