1111111111111
1111E00000001
1000000C00001
1P00000000V01
1111111111111