1111111111111
10P000C000E11
1111111111111