1111111111111111111111111111111111111111111111111111111111111111111111111111111111111111111111111111111111111111
1111111111111111111111111111111111111111111111111111111111111111111000000000000000000000000000000000000000000P11
1111111111111111111111111111111111111111111111111111111111111111111011100000000000000000000000000000000000000001
1111111111111111111111111111111111111111111111111111111111111111111011111111111111111111111111111111111111111111
1111111111111111111111111111111111110000000000000000000000000000000011111111111111111111111111111111111111111111
1111111000100000000000000000000000000000000000000000000000000000000011111111111111111111111111111111111111111111
11111110C0111111111111111111111111111111111111111111111111111111111011111111111111111111111111111111111111111111
1111111000111111111111111111111111111111111111111111111111111111111011111111111111111111111111111111111111111111
1111111101111111111111111111111111111111111100000000000000000000000011111111111111111111111111111111111111111111
1111111101111111111111111111111111111111111111111111111111111111111011111111111111111111111111111111111111111111
1111111101111111111111111111111111111111111111111111111111111111111011111111111111111111111111111111111111111111
1111111101111111111111111111111111111111111111111111111111111111111011111111111111111111111111111111111111111111
1111111101111111111111111111111111111111111111111111111111111111111011111111111111111111111111111111111111111111
1111111100000000000000000000000000000000000000000000000000000000000011111111111111111111111111111111111111111111
1111111111111111111111111111111111111101111111111111111111111111111111111111111111111111111111111111111111111111
1111111111111111111111111111111111111101111111111111111111111111111111111111111111111111111111111111111111111111
1111111111111111111111111111111111111101111111111111111111111111111111111111111111111111111111111111111111111111
1111111111111111111111111111111111111101111111111111111111111111111111111111111111111111111111111111111111111111
1111111111111111111111111111111111111101111111111111111111111111111111111111111111111111111111111111111111111111
11111111111111111111111111111111111111E1111111111111111111111111111111111111111111111111111111111111111111111111
1111111111111111111111111111111111111111111111111111111111111111111111111111111111111111111111111111111111111111
1111111111111111111111111111111111111111111111111111111111111111111111111111111111111111111111111111111111111111
1111111111111111111111111111111111111111111111111111111111111111111111111111111111111111111111111111111111111111
1111111111111111111111111111111111111111111111111111111111111111111111111111111111111111111111111111111111111111
