111111111111111111111
100000000000000010001
111E000000000000000C1
111111111P00000000001
111111111111111111111