11111111111111
1111000000E001
1110000000P001
11111110000001
11111111111111