111111111
1C0000001
100000P01
111111111
