1111111111
10000E0001
1000000C01
1000000001
1111111111
