11111111111111111111111
100000C0000000000000001
1111000000000P000000001
1C010000000E00000000001
11111111111111100000001
111111111111C0000000001
11111111111111111111111
