11111111111111111111111111
1000000000011000000C000001
10000000C00000000000011111
111111111111100000000000C1
10C000000E00000000P000001
1111110000001111100011111
1111111111111111111111111