10000000000000010000001
10000000000100000C00001
1P000000000000000000001
11111100000C00000100001
10000000000000000000001
1E0001000000001110000C1
11111111111011111111111