11111111111111111111111111111111111111111111111111111111111111111111111111111111111111111111111111
1P000000000000000000000000000000000000000C000000000000000000000000E0000000000000000000000000000001
11111111111111111111111111111111111111111111111111111111111111111111111111111111111111111111111111
